............................................................................................................................................
............................................................................................................................................
............................................................................................................................................
............................................................................................................................................
............................................................................................................................................
............................................................................................................................................
........................................++.............................................................+++++++.....+++......................
................................++.+++++++.............++++............................................+++++++..++++++......................
................................++++++++++.........++++++++..................................++.......+++++++.+++++++.......................
.........................++..++.++++++++++++++.....++++++++........++......................++++..++...++++++++++++++........................
.........................+++.+++++++++++++++++..++....++++++++..+++++++++.................++++++++++++++++.+++++++++++++....................
.........................++++++++++++++++.++++++++..++++++++++..+++++++++.................++++++++++++++++++++++++++++++....................
..........................++++++++++++++++++++++++..+++++++++...+++++++++..++++...........++.+++++++++++++++++++++++++......................
.................++.....++++++++++++++++++++++++++++++++++++++..++++++++..+++++..++++...+++++++++++++++++++++++++++++++.....................
..............++++++....+++++++++++++++++.++++++++++++++++.+++...++++++++++++++.+++++.+++++++++++++++.+++++++++++++++++.....................
..............++++++......++++++++++++++++++.+++++++++++++++++...++++++++++++++++++++++++++++++++++++++.++++++++++++.+++....................
................++++++++..++++++++++++++++++++++++++.+++++++++++++++++++++++++++++++++++++++++++++++++++++++++++++++++++....................
...............++++++++++++++++++++++++++++++++.+++++++++++++++++++++.+++++++++++++++++++++++++++++++++++++++++++++++++++...................
...............++++++++++++.++++++++++++++++++++++++++++++++++++++++++++++++++++.+++++++++++++++++++++++.+++++++++++++++++..................
..............++++++++.++++++++++++++++++++++++++++++++++++++++++++++++++++++++++++.++++++++++++++++++++++++++++++++++++++..................
.............++++++++++++++++++++++++++++++++++++++++++++++++++++++++++.+++++++++++++++++++++.++.+++++++++++++++++++++++.++.................
.............++++++.+++.+++++++++++++++.+++++++++++++++++++++++++++++++++++++.++++++++++++.++++++++++++++++++++++++++++++++++...............
..........++..+++++++++++++++++++++++++++++++++++++++++++++++++++++++++++++++++++.+++++++++++++++++.+++++++++++++.+++++++++++...............
..........+++.++++++++++++++.+++++++++++++++++++++.+++++++++++++++++++++++++++++.++.++++++++++.+++++++++.+++++++++++++++.++++...............
..........+++.+++++++.++++++++++++.+++++++++++++++++++++++++++++++++++++++++++++++++++++++++++++++++++++++++++++++++++++++++................
..........+++++.+++++++++++++++++++++++++++++++++++++++++++++++++++++++++++++++++++++++++++++++++.++++++++.+++++++.++.+++++++...............
..........++++++++++++++.++++++++++++.+++++++++++++++++++++++++++++++++++++++++++++.++++++++++++.++++++++++++++++++++++++++++...............
...........+++++++++++++++++++++++++++++.++++++++++++++++++++++++++++++++++++++++++++++++++++++++++++++.+++++++.++++++++++++.++.............
...........+++++++++++++++++++++++++++++++++++++++++++++++++++++++++++++++++++++++++++++++++++++++++++++++++++++++++++++++++.++.............
............+++++++++++++++++++++++++++++++.++++++++++++.++.+++++++++++++++++++++++++++++++++++++++++++++++++++++++++++++++++++.............
............+++++++++++++++++++++++++++++++++++++++++++++++++++++++++++++++++++++++++++++++++++++++++++++++++.++++++++++++++++++............
.............+++++++++++++++++.++++++++++++++++.++.+++++++++.++++++++++++++++++++++++++++++++.++++++++++++++++++++++++++++++++++....+++.....
.............+++++++++++++++++++++++++++++++++++++++++++++.++++++++++++++.++++++++.+++++++++++++++++++.++++++++++++++++++++++++++++++++.....
............+++++++++++++++++++++++++++++++++++++++.+++++++++++++++++++++++++++++++++++++++++++++++++++++++++++++.++++++++++++++++++++......
............+++++++++++++++++++++++++++++++++++.++++++++++++++++++++++.++++++++++++++++++++++++++++.+++++++++++.+++++++++++++++++++.........
.............+++++++++++.++++++++++++++++++++++++++++++++++++++++++++++++++++++++++++++++++++++++++++++++++++++++++++++++++++++++++.........
............++++++++++++++++++++++++.++++++++.+++++++++++++++++++++++++++++++++++++++++++++++++++++++.+++++++++++++++++++++++++++++.........
..........++++++++++++++++++++++++++++++++++++++++++++++++++++++++++++++++++++++++++++++++++.+++++++++++++++++++++++++++.+++++++++++.+++....
........++++++++++++++++.+++++++.++++.+++++++++++++++++++++++++++++++++++.++++++++++++.++++++++.++++++++.+++++++++++++++++++++++++++++++....
.......+++++++++++++++++++++++++++.++++++++++++++++++++++++++++++++++++++++++++++++++++++++++++++++++.++++++++++++++.++.+++++++++.+++++.....
.......++++++++++++.++++++++++++++++++++++++++++++++++++++++++++.+++++++++++++.++++++++++++++++++++++++++++++++++++++.++++++++++...+++++....
...++...+++++++++++++++++++++++++++++++++++++++++.+++++++++++++++++++++++++.++++.++++++++++++.++++++++++.++++++++++++++++++++++.++++++++....
...++...+++++++++++++++++++++++++++++++++++++++++++++++++++++++++.+++++++++++++++++++++++++++++++++++++++++++++++++++++++++++++++++++++.....
.++++++.+++++++++++++++.+++++++++++++++.++++++++++++++++.++++..++++++++++++++++++++++++++++++++++++.++++++++++++++++++++++++++++++++........
.+++++++++++++++++.+++++++++++++.++++++++++++++++++++.++++++++++++++++++++++++++++++++++++++++++++++++++++++++++++++++.++++++.+++++++.......
.+++++++++++++++++++++++++++++++++++++.++++++.+++++++++++++++++++++.++++++++++++++++++++++++++++++++.+++++++++++++++++++++++.++++++++.......
...++.+++++++++++++++++++++++++++++++++++++++++++++++++++++++.++++++.++++++++.++++++++++++++++++++++++++++++++++++++++++++++++++++++++......
....++++++++++++++++++++++.+++++++++++++++++++++++++++++++++++++++++++++++++++++++++++.++++++++++++++++++++++++++++++++++++++.++++++++......
....+++++++++++.+++++.+++++++++++++++++++++.+++++++++++++++++++++++++++.++.++++++++++++++++++++++++++++++++++++++++++++++++++++++.++........
....++++++++++++++++++.++++++++++++++++++++++++++++++.+++++++++++++++++++++++++.+++++++++++++++.+++++++++++++++++.+++++++++++++++++.........
....++...++++++++++++++++++++++++++++++++++++++++++++++++++++++++++++++++++++++++++++++++++++++++++++++++++++++++++++++++++++++++++.........
........+++++++++++.+++++.++++++++++++++++++++++++++++++.++.+++++++++++++++++++++++++++++++++++++++++++++++++++++++++++++++.++...++.........
......++++++++++++++++++++++++++++.++++++++++++++++++++++++++++++++++++++++++++++++++++++++++.+++++++++++++++++++++++++++++++++.............
....++++++++++++++.++.++.+++++++++++++.+++++++++++++++++++++++++++++++++++++++++++++++++++++++++++++++++++++++.++++++++++++++++++...........
....++++++++++++++++++++++++.++.++++++++++++++++++.+++++++++++++++++++++++++++++++++++++++++++++++++++++++++++++++++++++++.++++++...........
....++++++.+++++++++++++++++++++++.++++++.+++++.+++++++++++++++++++++++++++++++++++++++++++++.+++++++.++++++++++++++++++++++++++............
....++++++++++++++++++++++++++++++++++++++++++++++++++++++++++++++++++.+++++++++++++..+++++++++++++++++.++++++++++++++++++++++..............
......+++++++++++++++++++++++++++++++++++++++++++++++++++++++++++++++.++++++.+++++++.+++++++++++++++++++++++++++++++++++++++................
......++++++++.++++++++++++++++++++++++++++++++++++++++++++++.++++++++++++++++++++++++++++++++++++++++++++++++++++++++++++++................
......++++++++++++++++++++++++++++++++++++++++++++++++.++++....+++++++++++++++++++++++++++++++++++++++++++++++++++++++++.++.................
.....+++++++++++++++++++++.+++++++++++++++++++++++++++++.++....++++++.+++.++++++++++.+++++++++++.++++++++++++++++.++++++++++++..............
.....++++..++++++++++++++++++++++++++++++++++++.+++++++++++.....++++++++++++++.++++..++++++++++++++++++.++++++++++++++++++++++..............
.....++++........++++++++++++++++++++++++++++++++++++++++++++.....+++++++++++++++++++++++++++++++++.++++++++++++++++++++++.++...............
.................+++++.+++++++++++++++++++++++++++++++++++++++++.++++++++++++++++++++++++.++++.++++++++++++++++++++++++++++++...............
................++++++++++++++++++++++++++++++++++++++++++++++++++++++++++++.++++++++.+++++++++++++++++++++++++++++++++++++++...............
................+++++++++++++++++++++++++++++++++++++++++++++.+++++++++++++..++++++++++++++++++.+++++++++++++++.++++++.++++++...............
...........++...+++++++++++++++++++++++++++++++++.+++++++++++..+++++++++++++....+++++++++++++++++.++++++.+++++++++++++++++++++..............
......+++++++++.++++++++++++++++++++++++++++++++++++++++++++++.++..+++++++++....+++++++.++++++++++++++++++++++++++++++++++++++..............
......+++++++++.++++++++++++++++++++++++++++++++++++++++++++++++++.+++++++.........++++++++.+++++++++.++++++++++++++++++++.++++.............
.......++++++++.+++++++++++++++++.++++++++++++++++++++++++++++++++...+++++.............++++++++++++++++++++++++++++.++++++++++++............
.....+++++++++++++++++++++++++++++++++++++++++++.+++++++++++++++++....................++++++++.+++++++++++++++++++++++++++++++++............
.+++.+++++++++++++++++++++++++++++++++.+++++++++++++++++++++++++++.............++.....++++++++++++++++++++++++.++++++++.++++++..............
.+++.++++++++++++++++++++++++++++++++++++++++++++++++++++++++++++++............++..++++++++++++++++++++++++++++++++++++++++++++++++.........
.+++++++++++++++++++++++++++.+++++++++++++++.+++++++.+++++++++++++++..........++++.++++++++++++++++++++++++++++++++++++++++++++++++.........
.+++++++++++++++++.++++++++.++++.++++++++++.++++++++++++++++++++++++......++++++++..++++++++++++++++++++++.+++++++++++++++++++++++++........
.++++++++++++++++++++++++++++++++++++++++++++++++++++++++++++++++.++..+++++++++++++.+++++++++++++++++++++++++++++++++++++++++++++++++.......
.....+++++++++++++++++++++++++++++++++++++++++++++++++.+++++++++++....+++++++++++++++++++++++++++++++.+++++.++++++.++++.+++++++.+++++++.....
....++++..++.++++++++++++++.++.+++++++++++++++++++++++++++++++++++....+++.++++++++++++++++++++++..++++++++++++++++++++++++++++++++++++++....
....++++.++++++.++++++++++++++++.++++++++++++++++++++++++++++.+++...+++++.++++++++++++++++++++++++++++++++++++++++++++++++++++++++++++++....
.........++++++++++.++.++++++++++++++++++++++++++++++++.+++++++++...+++++++++++++++++++++++++.++++++++++++++++++.+++++++++++++++++++++......
.......+++++++++++++++++++++++++++++++.+++++++++++++++++++++++++.+++++++++++++++++++++++++.++++++++.+++++++++++++++++.++++++++.+++++++......
.......+++++++++++++++++++++++++++++.++++++++++++.+++++++++++.++++++++++++++++++++++++++++++++++++++++++++++.+++++++++++++++++++++++........
........++++++++++++++++++.+++++++++++++.++++++++++++++++++++++++.+++++++++++++++++++.+++++.++++.+++++++.+++++++++.+++++++++++++++..........
.......+++++++++++++++++++++++++++++++++++++++++++++++++++++++.++.++.++.++.++++++++++++++++++++++++++++++++++++++++++++++++++++++...........
....++.++++++++++++++++++++++.+++++++++++++++++++++++++++++++.+++++++++++++++++++++++++++++++++++++++++++++++++++++++++++++++++++...........
....+++++++.+++++++++++++++++++++++++++++++++++++++++++++++++++++++++++++++++++++++++++++++++++++++++++++++.++.++++++++++++++++.++..........
....++++++++++++++++++++++++++++++++++++++++++++++++++++.++++++++++++++++++++++++++++++++++++.++++++++++++++++++++++++++++++++++++++........
++++++++.+++++++++++++++++++++++.+++++++++.+++++++++++++++.++.+++++++++++++++++++.++++++++++++++++++++++++++++++++++++++++++++++++++........
++++.++.++++++++++++++++++++++++++++++++++++++++.++++++++++++++.++++++++.+++++++++++++++++++++++++++++++++++.++++++++++++++.++++++..........
.++++++.++++++++++++++++++++++++++++++++++++++++++++++.++.+++++++++++++++++++++++++++++++++++++++++.+++++++++++++++++++++++++++++++.........
.++++++..++.++++++++++++++++++++++++++++++++++++++++++++++.+++++++++++++++++++++++++++++.++++++++++++++++++++++++++++++++++++++++++.........
..++++........++++++++++++++++++++++.+++++++++++++++++++++++++++++++.+++++++++++++++++++++++++++++++++++++++.++++++++++++++.++.++...........
...+++..........++++++++.+++++++++++++++++++++++++++++++++++++++++.+++++++++++++++++++++++++++++++++++++++++++++++++++++++++++++++++........
...+++.......++++.+++++++++.+++++++++++++++++++++++++++++++++++++++++++++++++++++++++++++++.+++++++++++++++++++.++++++.+++++++++++++........
.............++++++++++++++++++++++++++++++++++++++++.+++++++++++++++++.++++++++++++++++++++++++++++++++++++++++.++++++++++++++++++.........
...........+++++++++++++++++++++++++++++++++++++++++++++++++++++++++++++++++++++.+++++++.++++++++++++++++++++++++++++++++++++++++++.........
...........++++++.++++++++++++++++++.+++++++++++++++++++++++++++++++++++++++.++++++++++++++++++++++++++.++++++++++++++++++++.+++++..........
............+++++++++++++++++++++++++++++++.++++++++++++++++++++++++++++.++++++++++++++++++++++++++.++++++++++++.+++++++++++++++++..........
...........++.+++++++++++++.++++++++++++++++++++++++++++++++++++++++++++++++++++++++++++++++++++++++++++++++++++++++++.++++++++++...........
...........+++++++++++++++++.+++++++++++++++++.++++++++++++++++++++++++++++++++++++++++++++++++++++++.++++++++++++++++++.+++++..............
...........++++++++++++++++++++++++++++++++++++++++++++++++++++++++++++++++++++++++++++++++++++++.+++++++++++++++.+++++++++++++.++..........
...........++++++++.++++++++++++++++++.++++++++++++++++++.+++.++++++++++++++++++++++++++++.++.++++.++++++++++++++++++++++++++++.++..........
........++.++++.++.+++++++++++++.++++++.++++.+++++++++++++++++++++++++++.+++++++++++++++++++++++++++++++++++++++++++++.+++++++++++..........
........++++++++++++++++++++++++++++++++++++++++++++++++++++++++++++++++++++++++++++++++++++++++++++++++++++++++++++++++++++++++++++++......
........++++++++++++++++++++++++++++.++++++++++++++++++.+++.+++++++++++++++++++++++++++++++++++++++++++++++++++++++++++++++++++++.++++......
.........+++++++++++++++++++++++++.++++++++++++++++++++++++++++++++++++++++++++++++++++++++++++++++++++++++++++++++++++++.++++++++++++......
.........++++++++++.++++++++++++++++++++++++++++++++++++++++.++.+++++++++++++++++++++++.++++++.+++++++++++++.+++++++++++++++++++++++++......
..........++++.+++++++++++++++++++++++++++++++++++++++++++++++++++++++++++++++++++++++++++++++++++++++++++++++++++++++++++++++.+++++++......
............++++.+++++++++++++++++++++++++++++++++++++++++++++++++++++++++++++.+++++++++++..+++++++++++++++++++++++++++++++++++++++++.......
.........++++++++++++++++++++++++++++++++++++++++++++++++++++++++++++++++++++++++++++++++++++++++++++++++++++++++++++++++++++++.+++.........
.........+++++++++++++++++++++++++++++++++++++++++++++++++++++++++++++++++++++++++++++++++++++++++++++++++++++++++++++++++.+++++++++........
........++++++++.++++++++++++++++++++++++++++++++.+++++++++++++++++.++++++++++++++++++++++++++++++++++++++++++++.+++++++++++++++++++........
........++++++++++++++++++++++++.++.+++++++++++++++.++++++++++++++++.+++++++++++++++++++++++++++++++++++++++++++++++++++++++++++++++........
..........+++++.++++++++++++++++++++++++++++++++++++++++++++++++++++++++++.+++++++++++++++++++++++++++++++++++++++++++++++++++++++++........
..........+++++.++.++++++++++++++++++++++++++.++++++++++++++++++++++++++++++++++++++++++++++.+++++++++++++++++++.+++++++++++++++++++........
...............++++++++++++++++++++++++.+++++++++++++++++++++++++++++++++++++++++++++++++++++++++++++++++++++++++++++++++++++++++++.........
...............++++++++.+++++++++++++++++++++++++++++++++++++++++++++++.++++.++++++++++.+++++++++++++++++++++.+++++++++++++++++++++.........
................++++++++++++++++++++++++++++++.+++++++++++++++++++++++.++++++++.++++++++++++++++++++++++++++++++++++++++++++++++++..........
..................+++++++++++++++++++++++++++++++++++++++++++++++++++++++++++++++++++++++++++++++++++++++++++++++++.+++++.+++++++...........
..................++++++++++++++++++++++++++++++++++++++++++++++++++++++++++++++++++++.++++++++++++++++++++++++++++++++++++++++++...........
.....................++++++++++++++++++++.++++++++++++.++++++++++++++++++++++++++++++++++++++++++++.++++++++++++.++++++++++++++++...........
......................++.++++.+++++++++++++++++++++++++++++++++++++++++++++++++++++++++.+++++++++++++++++++++++++.+++++++++++++++...........
.........................++.....++++++++++++++.++++++++++++++++.+++++++++++++++++.++++++++++++++++++++++++++++++++++++++++++.++.............
.................................+++++++++++.+++++++++++++++++++++++++++++++++++++++++++++.+++++++++++++++++++++++.++.++++++.++.............
.............................++.+++++++++++++++++++++++++++++++++++.++++++.+++++++++++++++++++++++++++.++++++.++++++++++++++................
.............................++++++.+++++++++++++++++++++++++++++++++++++++++++++++.+++++++++++++++.++++++.++.++++++++++++++................
.............................+++++...++++++++++++++..+++++++++++++++++.++++++++++++++++.+++++++++...+++++++++.+++.++++++++..................
.............................+++++..+++++++++++++++.++++++++++++++++++++++++.++++++++++.+++++..+++.++++++++++++++.++++++....................
.............................++++++.+++++++++++.++..++++++..+++++++++++++++++++++.++...+++++...+++++++++.++++++....++.......................
.............................++.+++..++++.+++++++....++++++.++++++++++.++++++++++++....+++++......+++.++.++.................................
.............................++..++.......+++++++......++++.+++++++++++++++++++++++.....++++.......++.......................................
.............................++...........+++++........+++..+++++++.+++++.++++..++......++..................................................
.............................................+++............++...++.++++++++++..............................................................
.............................................+++............++...++.++++++++++..............................................................
..............................................++.....................+++++++++..............................................................
.....................................................................+++++..................................................................
............................................................................................................................................
............................................................................................................................................
............................................................................................................................................
............................................................................................................................................
